1111111111
100C00C001
1E00000001
10PC000001
1111111111
