1111111111
1P00000001
1111111101
1110000001
111C111111
1110000001
1111111101
1110000001
11111111E1
1111111111
