11111111111111111111
1PCCCCCCCCCCCCCCC111
111111111111111C1111
111111111111111C1111
111111111111111C1111
11111CCCCCCCCCCC1111
111110C1111111111111
111110C1111111111111
111110C1111111111111
111110C1111111111111
111110CCCCCCCCCC0111
111111111111111C1111
111111111111111C1111
111111111111111C1111
111111111111111C1111
11CCCCCCCCCCCCCC1111
11C11111111111111111
11C11111111111111111
11CCCCCCCCCCCCCCC1E1
11111111111111111111
