1111111111
110C00C001
1E10000001
10PC000001
1111111111